NO ./texture/north.xpm
SO ./texture/south.xpm
WE ./texture/west.xpm
EA ./texture/east.xpm


F 0,0,0
C 255, 150, 0

DO ./texture/door.xpm

                 1111111111111111111111111
                 1000000000110000000000001                    1111111
                 1011000001110000000000001                    1000001
        11111111111001000000000000111111111                   1111111
11111111101100000111000000000000111
100000000011000001110111111111111
11110111111111011100000010001
11110111111111011101010010001
11000000110101011100000010001
10000000000000001100000010001
10000000000000001101010010001
11000001110101011111011110P0111
11110111 1110101 101111010001
11111111 1111111 111111111111