NO ./texture/north.xpm
SO ./texture/south.xpm
WE ./texture/west.xpm
EA ./texture/east.xpm


F 76,153,0
C 255,0,0


111111111111111111111111111
100000100010000000000000001
100010000111111101111111111
100000N000000111011
100010000111111100111111
100000000000000000000001
111111111111111111111111
