NO ./texture/north.xpm
SO ./texture/south.xpm
WE ./texture/west.xpm
EA ./texture/east.xpm


F 76,153,0
C 12,20,150


11111111111111111111111111
100000100010000000000000001
10001000011111110111111111
1000N0000000011101
10001000011111110011111
100000000000000000000001
11111111111111111111111