NO ./texture/north.xpm
SO ./texture/south.xpm
WE ./texture/west.xpm
EA ./texture/east.xpm


F 76,153,0
C 12,20,150


11111111111111111111111111  111
101000100010000000000000001 101
10100000001111110111111111  111
100000000010N1 101
10000000001111111011111
101000000000000000000001
11111111111111111111111