NO ./texture/north.xpm
SO ./texture/south.xpm
WE ./texture/west.xpm
EA ./texture/east.xpm


F ./200,220,0
C ./120,20,0



1111111111111111111111111
1000000000110000000000001
1011000001110000000000001
100100000000000000000000111111111
111111111011000001110000000000001
1a0000000011000001110111111111111
11110111111111011100000010001
11110111111111011101010010001
11000000110101011100000010001
10000000000000001100000010001
10000000000000001101010010001
11000001110101011111011110N0111
1111111111111111111111111111111