NO ./texture/north.xpm
SO ./texture/south.xpm
WE ./texture/west.xpm
EA ./texture/east.xpm


F 2,220,2
C 12,20,150


11111111111111111111111111  111
101000100010000000000000001 101
100000000000001110111111111 111
100000000000001 101
1000N000001100111011111
101000000000000000000001
11111111111111111111111