NO ./texture/north.xpm
SO ./texture/south.xpm
WE ./texture/west.xpm
EA ./texture/east.xpm


F 0,0,0
C 255 , 150 , 0

DO ./texture/door.xpm

111111111111111111111111111111111
111111111001000000100000000000001
111111111011000000100000000000001
111111111011000000100000010000001
111111111011000000100000010000001
111111111011000000100000010000001
111111111011000000100000010000001
11111111101100N000100000010000001
11111111100D000000D00000010000001
111111111011000001110010010000001
100000000011000000110011111111111
11111111111111111D111000000000001
111111111111111100011101001011111
111111000000110101011100000010001
111110000000000000001100000010001
111110000000000000001101010010001
111111000001110101011111011110011
111111110111 1110101 101111010001
111111111111 1111111 111111111111