   NO ./texture/wall_south.xpm

				SO./texture/wall_south.xpm
  WE ./texture/wall_south.xpm
			EA  	./texture/wall_south.xpm



F 0, 3,	 		  0


				C 0,100,225


DO ./texture/door.xpm


1111111111111111111111111111111111111111111111111111111111111111111111111111111111111111111111111111111111111111111111
1111111110100000011000000000000110000001000000000000000100000000000000000000000000000000000000000000000000000000000001
1111111110110000001000000000000010000001000000000000000100000000000000000000000000000000000000000000000000000000000001
1111111110110000001000000100000010000001000000000000000100000000000000000000000000000000000000000000000000000000000001
1111111110110000001000000100000010000001000000000111111100000000000000000000000000000000000000000000000000000000000001
111111111011000N001000000100000010000001000000000100000100000000000000000000000000000000000000000000000000000000000001
1111111110110000001000000100000010000001000000000100000100000000000000000000000000000000000000000000000000000000000001
1111111110110000001000000100000010000001000000000100000100000000000000000000000000000000000000000000000000000000000001
11111111100D000000D000000100000010000001000000000100000100000000000000000000000000000000000000000000000000000000000001
1111111110110000011100100100000010000001111110000111D11100000000100000000000000010000000000000000000000000000000000001
1000000000110000001100111111111110000001000010000000000100000000100000000000000010000000000000000000000000000000000001
11111111111111111D11100000000000D0000001000010000000000100000000100000000000000010000000000000000000000000000000000001
1111111111111111000111010010111110000001000010000000000100000000100000000011111110011111111111111111111111111111111001
1111110000001101010111000000100010000001000010000000000100000000100000000010000010010000000001000000000100000000001001
1111100000000000000011000000D00010000001000010000000000100000000100000000010000010010000000001000000000100000000001001
11111000000000000000110101001000100000010000D0000000000100000000100000000010000010010000000001000000000100000000001001
1111110000011101010111110111100010000001000010000000000100000000100000000010000010010000000001111D11111100000000001001
111111110111 1110101 10111101000100000011111111111D11111000000001111110000111D11100D0000000000000000000000000000001001
1000000000011100000111000000000000000000000000000000000100000000100001000000000010010000000000000000000000000000001001
100000000000000000000000000000000000000000000000000000000000000010000100000000001001000000000111D11100000000111D111001
1000000000000000000000000000000111111111111111111111111111111110100001000000000010010000000001000001000000001000001001
1000000000000000000000000000000100000000010000000001000000000010100001000000000010010000000001000001000000001000001001
1000000000000000000000000000000100000000010000000001000000000010100001000000000010011111111111111111111111111111111001
100000010000000000000001000000010000000001000000000100000000001010000D000000000010000000000000000000000000000000000001
100000010000000000000001000000010000000001111D111111000000000010100001000000000010000000000000000000000000000000000001
1000000100000000000000010000000D00000000000000000000000000000010111111111111111110000000000000000000000000000000000001
1000000100000000011111110000000100000000000000000000000000000010000000000000000010000000000000000000000000000000000001
10000001000000000100000100000001000000000111D11100000000111D1110000000000000000000000000000000000000000000000000000001
1000000100000000010000010000000100000000010000010000000010000010000000000000000000000000000000000000000000000000000001
1000000100000000010000010000000100000000010000010000000010000010000000000000000000000000000000000000000000000000000001
1000000100000000010000010000000111111111111111111111111111111110000000000000000000000000000000000000000000000000000001
10000001111110000111D1110000000000000000000000000000000000000000000000000000000000000000000000000000000000000000000001
1000000100001000000000010000000000000000000000000000000000000000000000000000000000000000000000000000000000000000000001
1000000100001000000000010000000000000000000000000000000000000000011111111111111111111111111111111000000000000000000001
1000000100001000000000010000000000000000000000000000000000000000010000000001000000000100000000001000000000000000000001
1000000100001000000000010000000111111111111111111111111000000000010000000001000000000100000000001000000000000000000001
1000000100001000000000010000000D00000000000000000000101000000000010000000001000000000100000000001000000000000000000001
100000010000D00000000001000000010000000000000000000010D000000000010000000001111D11111100000000001000000000000000000001
1000000100001000000000010000000111111111111111111111111000000000000000000000000000000000000000001000000000000000000001
1000000111111111111111110000000000000000000000000000000000000000010000000000000000000000000000001000000000000000000001
100000000000000000000001000000000000000000000000000000000000000001000000000111D11100000000111D111000000000000000000001
1000000010000000000100000000000000000000000000000000000000000000010000000001000001000000001000001000000000000000000001
1000000010000000000100000000011111111111111111111111111111111000010000000001000001000000001000001000000000000000000001
1000000010000000000100000000010000000001000000000100000000001000011111111111111111111111111111111000000000000000000001
1000000010000000000100000000010000000001000000000100000000001000000000000000000000000000000000000000000000000000000001
1000000010000000000100000000010000000001000000000100000000001000000000000001111111111111111111111111111111100000000001
1000000010000000000100000000010000000001111D11111100000000001000000000000001000000000100000000010000000000100000000001
10000000100000000001000000000D0000000000000000000000000000001000000000000001000000000100000000010000000000100000000001
1000000010000000000100000000010000000000000000000000000000001000000000000001000000000100000000010000000000100000000001
100000001111D11111110000000001000000000111D11100000000111D1110000000000000010000000001111D1111110000000000100000000001
100000001000000000010000000001000000000100000100000000100000100000000000000D000000000000000000000000000000100000000001
1000000010000000000100000000010000000001000001000000001000001000000000000001000000000000000000000000000000100000000001
1000000010000000000100000000011111111111111111111111111111111000000000000001000000000111D11100000000111D11100000000001
1000000010000000000100000000000000000000000000000000000000000000000000000001000000000100000100000000100000100000000001
1000000010000000000100000000000000000000000000000000000000000000000000000001000000000100000100000000100000100000000001
1000000010000000000100000000000000000000000000000000000000000000000000000001111111111111111111111111111111100000000001
1000000010000000000100000000000000000000000000000000000000000000000000000000000000000000000000000000000000000000000001
1111111111111111111111111111111111111111111111111111111111111111111111111111111111111111111111111111111111111111111111