NO ./texture/black_wall_no.xpm

								SO ./texture/black_wall_so.xpm
WE ./texture/black_wall_we.xpm
	EA ./texture/black_wall_ea.xpm



F 0,0,0



C 0,0,139

DO ./texture/door.xpm


        1111111111111111111111111
        1000000000110000000000001
        1011000001110000000000001
        10010000000D0000000000001
111111111011000001110000000000001
100000000011000001110111111111111
11110111111111011100000010001
11110111111111011101010010001
11000000110101D11100000010001
100000000000000011000000D0001
10000000000000001101010010001
1100000111010101111101111000111
11110111 1110101 10111101N001
11111111 1111111 1111111111111
1